13 7
0000000000000
0000000000000
0000500050000
0000001000000
0006000008000
0000000000000
0000000000000
