13 7
0060050060051
0000050000050
0050050050050
0050050050050
0050050050050
0050000050000
0150060050000
