13 7
0000000000000
0007000000000
0002002002000
0000000000000
0001001001000
0000000007000
0000000000000
