13 7
0000000000000
0000000000000
0007000007000
0000009000000
0001001001000
0000000000000
0000000000000
