13 7
2000000000002
0000000000000
0008000000000
0000011100000
0000000008000
0000000000000
0000000000000
