13 7
0000000000000
0000007000000
0002000002000
0060051500000
0002005002000
0000000000000
0000000000000
