13 7
0000000000000
0400000000040
0006070607000
0000009000000
0000000000000
1100000000011
0000000000000
