13 7
0000000000000
4400000000044
0000000000000
0000006000000
0000500050000
0080111110800
0000050500000
