13 7
0000000000000
0000007000140
0000000000000
0030007000000
0002200000000
0002000000000
0000000000000
