13 7
0120000000030
0000000000000
0000000007000
0040009000400
0007000000000
0000000000000
0000000000000
