13 7
0000000000000
0000008000000
0002005002000
0000050500000
0001005001000
0000008000000
0000000000000
