13 7
0000000000000
0000000006000
0000002000000
0040021200400
0000002000000
0006000000000
0000000000000
