13 7
0000000000000
0033000000000
0000001000000
0008001008000
0000001000000
0000000000000
0000000000000
