13 7
0000000000000
0000000000400
0010000004140
0000000000000
0000008000000
0000000000000
0000000000000
