13 7
0000000000000
0020000000400
0000000004140
0000000000000
0033008000000
0000000000000
0000000000000
