13 7
0000000000000
0044400000000
0001000000000
0000000000000
0000000677000
0002000000000
0000000000000
