13 7
0000000000000
0011000000400
0000000004040
0000000000000
0030009000000
0000000000000
0000000000000
