13 7
0000000000000
0040000000400
0010006000100
0000000000000
0040000000400
0000000000000
0000000000000
