13 7
0000000000800
0001020102000
0080000000000
0002010201000
0000000000800
0001020102000
0080000000000
