13 7
1000007000001
5555550555555
0000000000000
0000000060000
0000006000000
0000600000033
0000000000000
