13 7
0000000000000
0000008000000
0000003000000
0600030300060
0000003000000
0000008000000
0000000000000
