13 7
0000000000000
0100000000010
0008000000000
0000044400000
0000000008000
0100000000010
0000000000000
