13 7
0000000000000
0400007000040
0000000000000
0000001000000
0000000000000
0300006000030
0000000000000
