13 7
0800000000000
1100000000000
0000000000000
0000000340000
0000000000000
0000000000000
0000000000000
