13 7
0000000000000
0000000700000
0006000000000
0000000001000
0004200004000
0000000000000
0000000000000
